[
    {
    "type": "mapgen",
    "method": "json",
    "weight": 9999,
    "om_terrain": [ "shelter_3" ],
    "object": {
      "rows": [
        "    `!!!!`!!!!`!!!!`    ",
        "    `!!!!`!!!!`!!!!`    ",
        "    `!!!!`!!!!`!!!!`    ",
        "    `!!!!`!!!!`!!!!`    ",
        "    `!!!!`!!!!`!!!!`    ",
        "    &&&&&&&&&&&&&&&&    ",
        "       |-:-++-:-|       ",
        "    |--|........|--|    ",
        "    |*|c...bb...ccc|    ",
        "    |=|............|    ",
        "   --......bb......--   ",
        "   |b..............b|   ",
        "   :b..............b:   ",
        "   |b...|--++--|...b|   ",
        "   |c..l|>....>|l..c|   ",
        "   |c..l|>....>|l..c|   ",
        "   |b...|--++--|...b|   ",
        "   :b..............b:   ",
        "   |b..............b|   ",
        "   --ccc..b..b..ccc--   ",
        "    |..c..b..b..c..|    ",
        "    |6....b..b....x|4   ",
        "    |--|........|--|    ",
        "       |-:--+-:-|       "
      ],
      "palettes": [ "shelter" ],
      "items": { "l": { "item": "shelter_supplies", "chance": 20, "repeat": [ 0, 1 ] } },
      "computers": {
        "6": {
          "name": "Evac shelter computer",
          "options": [
            { "name": "Emergency Message", "action": "emerg_mess" },
            { "name": "Disable External Power", "action": "complete_disable_external_power" },
            { "name": "Contact Us", "action": "emerg_ref_center" }
          ]
        }
      }
    }
  },
  {
    "type": "mapgen",
    "method": "json",
    "om_terrain": "shelter_roof_3",
    "weight": 9999,
    "object": {
      "fill_ter": "t_flat_roof",
      "rows": [
        "                        ",
        "                        ",
        "                        ",
        "                        ",
        "                        ",
        "                        ",
        "       4444444443       ",
        "    |44|........3443    ",
        "    |>.............3    ",
        "    |..........#...3    ",
        "   ||..:...........33   ",
        "   |................3   ",
        "   |................3   ",
        "   |................3   ",
        "   |................3   ",
        "   |................3   ",
        "   |................3   ",
        "   |................3   ",
        "   |................3   ",
        "   ||...&..........33   ",
        "    |..............3    ",
        "    |..............5    ",
        "    |--|........|--3    ",
        "       |--------|       "
      ],
      "terrain": {
        ".": "t_flat_roof",
        " ": "t_open_air",
        "-": "t_gutter_south",
        "|": "t_gutter_west",
        "3": "t_gutter_east",
        "4": "t_gutter_north",
        ">": "t_ladder_down",
        "5": "t_gutter_drop"
      },
      "furniture": { ":": "f_standing_tank", "#": "f_solar_unit", "&": "f_roof_turbine_vent" },
      "place_items": [ { "item": "roof_trash", "x": [ 8, 15 ], "y": [ 7, 22 ], "chance": 50, "repeat": [ 1, 3 ] } ]
    }
  }
]