[  
  {
    "type": "mapgen",
    "method": "json",
    "weight": 100,
    "om_terrain": [ "shelter_1" ],
    "object": {
      "rows": [
        "    !!!!!!!!!!!!!!!!    ",
        "    `!!!!`!!!!`!!!!`    ",
        "    `!!!!`!!!!`!!!!`    ",
        "    `!!!!`!!!!`!!!!`    ",
        "    `!!!!`!!!!`!!!!`    ",
        "    `!!!!`!!!!`!!!!`    ",
        "    `!!!!`!!!!`!!!!`    ",
        "    &&&|---++---|&&&    ",
        "       |........|       ",
        "    |-:|........|       ",
        "    |...........|:-|    ",
        "    |.bbbbb.....c.6|    ",
        "    |...........c..|    ",
        "    :.bbbbb.....c..:    ",
        "    |...........cc.|    ",
        "    |.bbbbb........|    ",
        "    |........|||...|    ",
        "    |.-----..|*=...|    ",
        "    :........|||...:    ",
        "    |.b.b.b...c|-+-|    ",
        "    |.b.b.b...c|..l|    ",
        "    |.b.b.b...c|>.l|    ",
        "    |..........|>.l|4   ",
        "    |----:--+-:----|    "
      ],
      "palettes": [ "shelter" ],
      "items": { "l": { "item": "shelter_supplies", "chance": 20, "repeat": [ 0, 1 ] } },
      "computers": {
        "6": {
          "name": "Evac shelter computer",
          "options": [
            { "name": "Emergency Message", "action": "emerg_mess" },
            { "name": "Disable External Power", "action": "complete_disable_external_power" },
            { "name": "Contact Us", "action": "emerg_ref_center" }
          ]
        }
      }
    }
  },
  {
    "type": "mapgen",
    "method": "json",
    "weight": 100,
    "om_terrain": [ "shelter_1" ],
    "//": "Evac Shelter Type B, Variant 2 (shelter_1)",
    "object": {
      "rows": [
        "    !!!!!!!!!!!!!!!!    ",
        "    `!!!!`!!!!`!!!!`    ",
        "    `!!!!`!!!!`!!!!`    ",
        "    `!!!!`!!!!`!!!!`    ",
        "    `!!!!`!!!!`!!!!`    ",
        "    `!!!!`!!!!`!!!!`    ",
        "    `!!!!`!!!!`!!!!`    ",
        "    &&&|---++---|&&&    ",
        "       |bb....bb|       ",
        "    |-:|b......b|       ",
        "    |x.c........|:-|    ",
        "    |..c........b.c|    ",
        "    |.cc........b.c|    ",
        "    :...........b.c:    ",
        "    |c.b........b.c|    ",
        "    |c.b...........|    ",
        "    |c.b....l|||...|    ",
        "    |c.b....l|*=...|    ",
        "    :.......l|||...:    ",
        "    |........bb|-+-|    ",
        "    |.........b|..l|    ",
        "    |.........b|>.l|    ",
        "    |6cccc...bb|>.l|4   ",
        "    |----:--+-:----|    "
      ],
      "palettes": [ "shelter" ],
      "items": { "l": { "item": "shelter_supplies", "chance": 20, "repeat": [ 0, 1 ] } },
      "computers": {
        "6": {
          "name": "Evac shelter computer",
          "options": [
            { "name": "Emergency Message", "action": "emerg_mess" },
            { "name": "Disable External Power", "action": "complete_disable_external_power" },
            { "name": "Contact Us", "action": "emerg_ref_center" }
          ]
        }
      }
    }
  },
  {
    "type": "mapgen",
    "method": "json",
    "om_terrain": "shelter_roof_1",
    "weight": 100,
    "object": {
      "fill_ter": "t_flat_roof",
      "rows": [
        "                        ",
        "                        ",
        "                        ",
        "                        ",
        "                        ",
        "                        ",
        "                        ",
        "       4444444444       ",
        "       |........3       ",
        "    |44|........3       ",
        "    |...........3443    ",
        "    |..............3    ",
        "    |..............3    ",
        "    |..............3    ",
        "    |..............3    ",
        "    |..............3    ",
        "    |........:.....3    ",
        "    |.........>....3    ",
        "    |..............3    ",
        "    |.......&......3    ",
        "    |..............3    ",
        "    |..............3    ",
        "    |............#.5    ",
        "    |--------------3    "
      ],
      "terrain": {
        ",": "t_flat_roof",
        " ": "t_open_air",
        "-": "t_gutter_south",
        "|": "t_gutter_west",
        "3": "t_gutter_east",
        "4": "t_gutter_north",
        ">": "t_ladder_down",
        "5": "t_gutter_drop"
      },
      "furniture": { ":": "f_standing_tank", "#": "f_solar_unit", "&": "f_roof_turbine_vent" },
      "place_items": [ { "item": "roof_trash", "x": [ 5, 17 ], "y": [ 11, 22 ], "chance": 50, "repeat": [ 1, 3 ] } ]
    }
  }]