[
  {
      "type": "mapgen",
      "method": "json",
      "weight": 100,
      "om_terrain": [ "shelter" ],
      "object": {
        "rows": [
          "    !!!!!!!!!!!!!!!!    ",
          "    `!!!!`!!!!`!!!!`    ",
          "    `!!!!`!!!!`!!!!`    ",
          "    `!!!!`!!!!`!!!!`    ",
          "    `!!!!`!!!!`!!!!`    ",
          "    `!!!!`!!!!`!!!!`    ",
          "    `!!!!`!!!!`!!!!`    ",
          "    &&&&&&&&&&&&&&&&    ",
          "    |----:-++-:----|    ",
          "    |llll......c..6|    ",
          "    |.b.b.b....c...|    ",
          "    |.b.b.b....c...|    ",
          "    |.b.b.b....c...|    ",
          "    :.b.b.b........:    ",
          "    |..............|    ",
          "    |......>>......|    ",
          "    |......>>......|    ",
          "    |..............|    ",
          "    :.b.b.b........:    ",
          "    |.b.b.b....c...|    ",
          "    |.b.b.b....c...|    ",
          "    |--.b.b....c...|    ",
          "    |*=........c..x|    ",
          "    |----:--+-:----|4   "
        ],
        "palettes": [ "shelter" ],
        "items": { "l": { "item": "shelter_supplies", "chance": 20, "repeat": [ 0, 1 ] } },
        "computers": {
          "6": {
            "name": "Evac shelter computer",
            "options": [
              { "name": "Emergency Message", "action": "emerg_mess" },
              { "name": "Disable External Power", "action": "complete_disable_external_power" },
              { "name": "Contact Us", "action": "emerg_ref_center" }
            ]
          }
        }
      }
  },
  {
    "type": "mapgen",
    "method": "json",
    "weight": 100,
    "om_terrain": [ "shelter" ],
    "object": {
      "rows": [
        "    !!!!!!!!!!!!!!!!    ",
        "    `!!!!`!!!!`!!!!`    ",
        "    `!!!!`!!!!`!!!!`    ",
        "    `!!!!`!!!!`!!!!`    ",
        "    `!!!!`!!!!`!!!!`    ",
        "    `!!!!`!!!!`!!!!`    ",
        "    `!!!!`!!!!`!!!!`    ",
        "    &&&&&&&&&&&&&&&&    ",
        "    |--:---++---:--|    ",
        "    |..............|    ",
        "    |.bbbbb..bbbbb.|    ",
        "    :..............:    ",
        "    |.bbbbb..bbbbb.|    ",
        "    |..............|    ",
        "    |......6x......|    ",
        "    |c....----....c|    ",
        "    :c...l|>>|l...c:    ",
        "    :c...l|++|l...c:    ",
        "    |c............c|    ",
        "    |..............|    ",
        "    |..............|    ",
        "    |--............|    ",
        "    |*=............|    ",
        "    |----:----:--+-|4   "
      ],
      "palettes": [ "shelter" ],
      "items": { "l": { "item": "shelter_supplies", "chance": 20, "repeat": [ 0, 1 ] } },
      "computers": {
        "6": {
          "name": "Evac shelter computer",
          "options": [
            { "name": "Emergency Message", "action": "emerg_mess" },
            { "name": "Disable External Power", "action": "complete_disable_external_power" },
            { "name": "Contact Us", "action": "emerg_ref_center" }
          ]
        }
      }
    }
  },
  {
    "type": "mapgen",
    "method": "json",
    "weight": 100,
    "om_terrain": [ "shelter" ],
    "object": {
      "rows": [
        "    !!!!!!!!!!!!!!!!    ",
        "    `!!!!`!!!!`!!!!`    ",
        "    `!!!!`!!!!`!!!!`    ",
        "    `!!!!`!!!!`!!!!`    ",
        "    `!!!!`!!!!`!!!!`    ",
        "    `!!!!`!!!!`!!!!`    ",
        "    `!!!!`!!!!`!!!!`    ",
        "    &&&&&&&&&&&&&&&&    ",
        "    |-----:++:-----|    ",
        "    |bbbb......bbbb|    ",
        "    :b............b:    ",
        "    |bbbb......bbbb|    ",
        "    |------++------|    ",
        "    |6............x|    ",
        "    :..............:    ",
        "    |l.....>>.....l|    ",
        "    |l.....>>.....l|    ",
        "    :..............:    ",
        "    |ccccc....ccccc|    ",
        "    |------++------|    ",
        "    :..............|    ",
        "    |=|c...........:    ",
        "    |*|ccc.........|    ",
        "    |----:-------+-|4   "
      ],
      "palettes": [ "shelter" ],
      "items": { "l": { "item": "shelter_supplies", "chance": 20, "repeat": [ 0, 1 ] } },
      "computers": {
        "6": {
          "name": "Evac shelter computer",
          "options": [
            { "name": "Emergency Message", "action": "emerg_mess" },
            { "name": "Disable External Power", "action": "complete_disable_external_power" },
            { "name": "Contact Us", "action": "emerg_ref_center" }
          ]
        }
      }
    }
  },
  {
      "type": "mapgen",
      "method": "json",
      "om_terrain": "shelter_roof",
      "weight": 100,
      "object": {
        "fill_ter": "t_flat_roof",
        "rows": [
          "                        ",
          "                        ",
          "                        ",
          "                        ",
          "                        ",
          "                        ",
          "                        ",
          "                        ",
          "    4444444444444444    ",
          "    |............#.3    ",
          "    |..............3    ",
          "    |..............3    ",
          "    |..............3    ",
          "    |..............3    ",
          "    |..............3    ",
          "    |..............3    ",
          "    |..............3    ",
          "    |..............3    ",
          "    |..............3    ",
          "    |..............3    ",
          "    |.:............3    ",
          "    |...........&..3    ",
          "    |>.............3    ",
          "    |--------------5    "
        ],
        "terrain": {
          ",": "t_flat_roof",
          " ": "t_open_air",
          "-": "t_gutter_south",
          "|": "t_gutter_west",
          "3": "t_gutter_east",
          "4": "t_gutter_north",
          ">": "t_ladder_down",
          "5": "t_gutter_drop"
        },
        "furniture": { ":": "f_standing_tank", "#": "f_solar_unit", "&": "f_roof_turbine_vent" },
        "place_items": [ { "item": "roof_trash", "x": [ 5, 17 ], "y": [ 9, 22 ], "chance": 50, "repeat": [ 1, 3 ] } ]
      }
  }
]